1111111111111111111111
1000001C1111E101111111
1000000CPC000100001001
1C10000111000001100111
1111111111111111111111