1111111111111111111111
1000001C1111E101111111
10000000C00000C1111111
1000000CPC000100001001
1C10000111000001100111
1000010000111000000011
1000110110000001001011
1000100000000C00001111
101010000D000010001111
1001000C010C0010001111
100010010000000C001111
1111111111111111111111