1111111111111111111111
1000001C11111101011111
10000000C00000C1111111
1000000C0C000100001001
1C100001CC000011001111
1000010000111000000011
1000110110000001001011
1000100000000C00001111
1010100000000010001111
1001000C010C0010001111
1P0010010000000C0E1101
1111111111111111111111
