1111111111111111111111
1000000C1111E101111111
10000000000000C1111111
10000000P0000100001001
1C10000111000001100111
1000010000111000000011
1000110110000001001011
1000100100000C00001111
1111111111111111111111