1111111111111111
1000000C1111E101
10000000000000C1
10000000P0000001
1C10000000000001
1111111111111111